S 0 0 1 0 0 0 F F 0 0 0 1 0 G
0 0 0 1 0 1 0 F F 0 0 0 1 0 0
0 1 0 0 0 1 0 0 0 0 1 0 0 0 0
0 1 1 1 0 1 1 1 0 0 1 0 1 1 0
0 0 0 0 0 0 0 0 0 0 0 0 0 0 0
W W 0 1 1 1 0 1 1 1 0 1 1 W W
0 0 0 0 0 0 0 0 0 0 0 0 0 0 0
0 1 1 0 F F 0 1 0 F F 0 1 1 0
0 0 1 0 F F 0 0 0 F F 0 1 0 0
0 0 0 0 0 0 0 1 0 0 0 0 0 0 0
W W W 0 0 0 0 1 0 0 0 0 W W W
0 0 0 0 1 0 0 0 0 0 1 0 0 0 0
